MMMMMMMMMMMMMMMMMMMMMMMMMMMMMMMM
MDDTTTDMTTTTRTTTTTTTTTTTTTTTDTTM
MMMMTTTMTTTDRDTTTTTTTMTTTTRTTTTM
MTTTTRTMTMMMMMMMMMMMMMTTTTTTTTTM
MTTTTTTMTTTTTTTTTTTTRTTTTTTTTTTM
MTTMMMMMTTTTTTTTTRTRTTTTTTTTTTTM
MTTTDTTTTTMTTTTTTTDTTTTTTTTTTTTM
MTTTTTTTTTMTTTTTTRTRTTTTTTTTTTTM
MTTTTTTTTMMRTTTTTTTTTTTTTTRRTTTM
MMMMMMMMTTMTTTMMMMMMMMMMMMMMMMMM
MTTTTTTTRTMTTTTTTTTTTTTTTTRTTTTM
MTRRTTTTTTMTTTTMMMMMTTTTTTRTTRTM
MTTTTRTTTTMTTTTTTDTTTTTTTTTTTTTM
MTTTRRRRRRRRRRRRRRRRRRRRRTRRRTTM
MTTDTTTTTPTTTTTTTTTTTTTTTTRTTDTM
MMMMMMMMMMMMMMMMMMMMMMMMMMMMMMMM