MMMMMMMMMMMMMMMMMMMMMMMMMMMMMMMM
MTTTTTDTTTTTRTTTTTTTTTTTTTTTTTTM
MTTTTTTTTTTDRDTTTTTTTTTTTTPTTTTM
MTTTTRTTTTTTTTTTTTTTTTTTTTTTTTTM
MTTTTTTTTTTTTTTTTTTTRTTTTTTTTTTM
MTTTTTTTTTTTTTTTTRTRTTTTTTTTTTTM
MMMMMMMMMMMMMMTTTTDTTTTTTTTTTTTM
MTTTTTTTTTTTTTTTTRTRTTTTTTTTTTTM
MTTTTTTTTTRTTTTTTTTTTTTTTTRRTTTM
MTTTTTTTTTTTTTTTTTTTTTTTTTTTTTTM
MTTTTTTTRTTTTTTTTTTTTTTTTTRTTTTM
MTTTTTTTTTTTTTTMMMMMTTTTTTRTTTTM
MTTTTRTTTTTTTTTTTDTTTTTTTTTTTTTM
MTTTTTTTTTTTTTTTTTRTTTTTTTTTTTTM
MTTTTTTTTTTTTTTTTTTTTTTTTTRTTTTM
MMMMMMMMMMMMMMMMMMMMMMMMMMMMMMMM