MMMMMMMMMMMMMMMMMMMMMMMMMMMMMMMM
MTPTTTTDTTTTTTTTTTTTTTTTTDTTTTTM
MTTTTTTTTTTTTTTTDTTTTTTTDTTTTTTM
MTTTDTTTTTTTTTTTTTTTTTDTTTTTTTTM
MTTTTTTTTTTTTDTTTTRTTTTTTRVTTTTM
MTTDTTTTTTTTTTTTTTTTTTTTVDDTTTTM
MTTTTTTTRTTRTTTTTTTRTTTTTRDTTTTM
MTTTTTTTTRRRTTTTTTTTTTTTTTTTTTTM
MTTTTTTTTTRTTTTTTTRTTTTTTTTTTTTM
MTTTTTTTTTRTTTTTTTTTTTTTTTTTTTRM
MTTTTTTTTTRTTTTTDTTTTTTRTRRTRTTM
MTTTTTTTTTRTTTTTTTTTTTTTTTTTTTTM
MTTTTTTTTTRTTTTTTTTDTTTTTTTTTTTM
MTTTDTTTTTDTTTTTTTTTTDTTTTTTTTTM
MTTTTTTTTTTTTTTTTTTTTTTTTTTTTTTM
MMMMMMMMMMMMMMMMMMMMMMMMMMMMMMMM