MMMMMMMMMMMMMMMMMMMMMMMMMMMMMMMM
MTPTTTTDTTTTTTTTTTDTTTTTTDTTTTTM
MTTTTTTTRTTTTTTTDTTTTTTTDTTTTTTM
MTTTDTTTDTTRTTTTTTDTTTDTTTTTTTTM
MTTTTTRTTTTTTDTTTTRTTTRTTRVTTTTM
MTTDTTTTTTTTTTTTDTTTTTTTVDDTTTTM
MMMMMMMMMMMMMMMMMMMMMMTTTTTRTTTM
MTTDTTRTTRRRTTTTTTTTTTTTDTTTTTTM
MTTDTTTTTTRMTMMMMMMMMMMMMMMMMMMM
MTTTTDTTTTRTTTRTTTTTTTTTTTTTTTRM
MTTTTTRTTTRTTTTTDTDTTTTRTRRTRTTM
MMMMMMMTMMMMMMMMMMMMMMTTTTDTTTTM
MTTTTTTTTTRTTTTTTTTRTTTTTTRTTTTM
MTTTDTTDTTDTTTTRTTTTDTTTTTTDTTMM
MTTTTTTTTTTTTTTTTTDTTTTTTTTTTTTM
MMMMMMMMMMMMMMMMMMMMMMMMMMMMMMMM